rang,équipe,points,matches,wins,draws,losses,goals_for,goals_against,goal_diff
1,Paris Saint-Germain,5838,1034,565,251,218,1874,971,903
2,Olympique Lyonnais,5682,1035,549,247,239,1760,1088,672
3,Olympique Marseille,5187,1035,485,274,276,1539,1122,417
4,AS Monaco,5029,1035,479,282,274,1591,1145,446
5,Lille OSC,5002,1051,478,304,269,1452,1042,410
6,Girondins Bordeaux,4419,996,405,298,293,1309,1123,186
7,Stade Rennais,4416,1035,401,269,365,1349,1223,126
8,OGC Nice,4241,1059,392,324,343,1223,1167,56
9,RC Lens,4094,1035,409,307,319,1308,1158,150
10,AS Saint-Étienne,4004,1058,393,300,365,1288,1276,12
11,Montpellier HSC,3755,1042,361,286,395,1275,1331,-56
12,AJ Auxerre,3746,1039,380,300,359,1261,1204,57
13,FC Nantes,3732,1035,350,288,397,1134,1223,-89
14,Toulouse FC,3642,1043,354,296,393,1199,1239,-40
15,FC Lorient,3635,1051,383,291,377,1331,1341,-10
16,FC Sochaux,3382,1050,366,312,372,1208,1217,-9
17,FC Metz,3310,1035,363,297,375,1180,1247,-67
18,SM Caen,3258,1065,369,318,378,1302,1318,-16
19,EA Guingamp,3209,1052,368,304,380,1286,1288,-2
20,ESTAC Troyes,3174,1054,381,281,392,1254,1282,-28
21,AS Nancy Lorraine,3136,1048,362,314,372,1209,1222,-13
22,Havre AC,3100,1043,368,320,355,1192,1166,26
23,RC Strasbourg,3055,952,329,292,331,1170,1179,-9
24,SC Bastia,2931,935,336,250,349,1100,1108,-8
25,AC Ajaccio,2902,1046,348,301,397,1084,1267,-183
26,Stade de Reims,2860,982,350,304,328,1174,1128,46
27,Stade Brestois 29,2784,941,346,265,330,1134,1098,36
28,Angers SCO,2741,1053,347,327,379,1158,1235,-77
29,Clermont Foot 63,2556,982,350,310,322,1175,1151,24
30,Amiens SC,2473,1056,351,335,370,1177,1211,-34
31,Valenciennes FC,2449,980,315,302,363,1119,1191,-72
32,Nîmes Olympique,2394,1048,360,303,385,1274,1314,-40
33,Dijon FCO,2376,940,324,278,338,1137,1200,-63
34,LB Châteauroux,2356,1034,331,318,385,1160,1312,-152
35,Stade Lavallois,2337,1044,354,324,366,1216,1216,0
36,Le Mans FC,2272,854,297,268,289,1000,1000,0
37,Chamois Niortais,2197,980,305,326,349,1114,1174,-60
38,CS Sedan,2001,728,261,237,230,906,843,63
39,Grenoble Foot 38,1861,752,252,235,265,821,847,-26
40,Paris FC,1693,815,309,245,261,958,884,74
41,US Créteil-Lusitanos,1610,877,281,283,313,1009,1044,-35
42,FC Istres,1377,674,217,207,250,735,826,-91
43,Tours FC,1311,638,207,188,243,740,791,-51
44,Red Star FC,1182,653,239,178,236,804,813,-9
45,US Boulogne,1172,681,234,201,246,782,790,-8
46,FC Gueugnon,1153,538,152,173,213,544,663,-119
47,Pau FC,1143,701,228,205,268,802,887,-85
48,Gazélec FC Ajaccio,1072,585,205,159,221,651,711,-60
49,Évian Thonon Gaillard,954,380,135,101,144,458,458,0
50,US Orléans,932,543,189,166,188,642,645,-3
51,AS Cannes,914,530,190,159,181,601,602,-1
52,AS Beauvais,875,500,160,165,175,544,572,-28
53,Rodez AF,858,446,151,126,169,524,536,-12
54,USL Dunkerque,778,421,159,111,151,501,483,18
55,FC Bourg-Péronnas,716,461,152,133,176,537,595,-58
56,FC Martigues,705,446,138,143,165,474,544,-70
57,AC Arles-Avignon,637,304,87,106,111,290,368,-78
58,Louhans-Cuiseaux,629,458,144,124,190,482,622,-140
59,ASOA Valence,626,308,103,100,105,378,374,4
60,US Quevilly-Rouen,626,396,115,120,161,459,544,-85
61,ES Wasquehal,612,308,79,111,118,285,354,-69
62,Vannes OC,590,338,115,104,119,381,403,-22
63,FC Sète,513,372,124,118,130,406,404,2
64,FC Rouen 1899,509,345,124,108,113,407,390,17
65,US Concarneau,459,307,110,91,106,369,363,6
66,Étoile FC,455,364,114,113,137,409,463,-54
67,US Avranches,435,328,118,81,129,393,433,-40
68,FC Annecy,420,190,69,56,65,242,235,7
69,AS Cherbourg,413,342,97,122,123,380,417,-37
70,FC Chambly,412,268,87,78,103,316,349,-33
71,Racing Besançon,375,266,88,73,105,297,306,-9
72,FC Libourne-Saint-Seurin,363,228,72,71,85,242,259,-17
73,Entente SSG,358,294,85,103,106,323,362,-39
74,FC Villefranche Beaujolais,335,238,83,86,69,277,253,24
75,RC France 92,319,222,81,76,65,249,227,22
76,SO Romorantin,292,228,72,76,80,250,274,-24
77,US Raon l'Etape,287,260,67,86,107,243,312,-69
78,SR Colmar,283,218,74,61,83,247,266,-19
79,Pacy Vallée,275,228,69,68,91,253,297,-44
80,SO Cholet,274,227,70,64,93,279,337,-58
81,Aviron Bayonnais,262,230,66,64,100,215,289,-74
82,Luzenac Ariège Pyrénées,258,188,67,57,64,231,225,6
83,SAS Épinal,247,246,57,76,113,271,373,-102
84,AS Béziers,245,163,52,51,60,179,201,-22
85,AS Angoulême Charente,231,184,58,57,69,193,222,-29
86,Olympique Noisy-le-Sec Banlieue 93,221,184,57,50,77,160,216,-56
87,CA Bastia,220,178,46,58,74,172,243,-71
88,AS Lyon Duchère,213,159,53,54,52,183,196,-13
89,SC Toulon,201,143,37,44,62,132,173,-41
90,Le Poiré-sur-Vie VF,188,144,50,38,56,161,177,-16
91,Marseille Consolat,185,134,51,32,51,179,191,-12
92,FC Versailles,154,110,40,34,36,137,125,12
93,Thouars Foot 79,151,146,36,43,67,145,197,-52
94,Olympique Alès-en-Cévennes,150,114,39,33,42,133,139,-6
95,Luçon VF,143,102,36,35,31,117,116,1
96,Stade Briochin,138,113,33,39,41,124,135,-11
97,La Roche-sur-Yon VF,131,114,34,29,51,129,159,-30
98,FC Mulhouse,122,78,20,21,37,91,112,-21
99,US Lusitanos de Saint-Maur,119,108,29,32,47,105,133,-28
100,Vendée Les Herbiers,117,100,25,42,33,119,138,-19
101,FC Borgo,116,125,25,41,59,131,200,-69
102,Calais RUFC,106,114,23,37,54,96,148,-52
103,USJA Carquefou,104,72,26,26,20,85,65,20
104,Stade Plabennec,89,78,22,23,33,74,107,-33
105,SO Châtellerault,80,76,18,26,32,72,93,-21
106,SO Cassis-Carnoux,79,76,19,22,35,74,106,-32
107,AS Moulins,79,76,20,19,37,81,118,-37
108,Paris 13 Atletico,78,77,16,30,31,73,97,-24
109,ASM Belfort,72,68,17,21,30,58,78,-20
110,US Colomiers,71,68,17,20,31,69,89,-20
111,Marignane Gignac,71,68,17,20,31,68,93,-25
112,Le Puy Foot 43,68,69,15,23,31,72,104,-32
113,ES Uzès Pont du Gard,66,72,15,21,36,56,108,-52
114,SC Aubagne Air Bel,59,42,16,11,15,54,48,6
115,Stade Poitevin,45,34,10,15,9,43,48,-5
116,Trélissac FC,43,38,9,16,13,46,57,-11
117,Gap FC,43,40,11,10,19,44,62,-18
118,Villemomble Sports,41,38,9,14,15,29,38,-9
119,ES Viry-Châtillon,39,38,8,15,15,36,51,-15
120,GOAL FC,38,34,10,8,16,43,47,-4
121,Saint-Denis Saint-Leu FC,38,34,9,11,14,32,42,-10
122,AS Évry,35,38,8,11,19,28,46,-18
123,Hyères FC,35,38,7,14,17,32,55,-23
124,US Roye,34,38,8,10,20,32,55,-23
125,AS Yzeure FC,32,38,7,11,20,45,69,-24
126,AS Saint-Priest,30,36,6,12,18,29,65,-36
127,UJA Alfortville,28,40,6,10,24,36,79,-43
128,JA Drancy,26,34,5,11,18,21,40,-19
129,Stade Beaucairois,17,38,3,8,27,26,79,-53
130,FC Fleury 91,13,10,3,4,3,12,9,3
